00I000000000000
001000011111100
001000010000100
001000010000100
00100001000011O
001000010000000
001000010000000
001000010000000
001000010000000
001000010000000
001111110000000
000000000000000
000000000000000
000000000000000
000000000000000