001000000000000
001000011111100
001000010000100
001000010000100
001000010000111
001000010000000
001000010000000
001000010000000
001000010000000
001000010000000
001111110000000
000000000000000
000000000000000
000000000000000
000000000000000