000I00000000000
00010001111111O
000100010000100
000100010000100
I1110001000011O
000100010000000
000111110000000
000100010000000
000111110000000
000000000000000
000000000000000
000000000000000
000000000000000
000000000000000
000000000000000